20 80
1 . . . 1 . . . . . . . . . . . . . . . . . . . . . . . . . . . . . . . . . . . . . . . . . . . . . . . . . . . . . . . . . . . . . . . . 2 . . 1 6 . . . . . 1
1 . . . 1 . . . . . . . . . 1 . . . . . . . . . . . . . . . . . . . . . . . . . . . . . . . . . . . . . . . . . . . . . . . . . . . . 2 . . . . . 1 5 . . . . 1
1 . . . 1 . . . . . . . . . 1 . . . . . . . . . . . . . . . . . . . . . . . . . . . . . . . . . . . . . . . . . . . . . . . . . . 2 . . . . . . . 1 . . . . . 1
1 . . . 1 . . . . . . . . . 1 . . . . . . . . . . . . . . . . . . . . . . . . . . . . . . . . . . . . . . . . . . . . . . . . 2 . . . . . . . . . 1 . . . . . 1
1 . . . . . . . . . . . . . 1 . . . . . . . . . . . . . . . y . . . . . . . . . . . . . . . . . . . . . . . . . . . . . . 2 . . . . . . . . . . . 1 . . . . . 1
1 . . . . . . 1 1 1 . . . . 1 . . . . . . . . . . . . . . . . . . . . . . . . . . . . . . . . . . . . . . . . . . . . 2 . . . . . . . . . . . . . 1 . . . . . 1
1 . . . . . 1 . . . . . . . 1 . . . . . . . . . . . . . . . . . . . . 1 . . 1 . . 1 . . 1 4 1 . . . . . . . y . . 2 . . . . . . . . . . . . . . . 1 . . . . . 1
1 . x . . 1 . . . . . . . . . . . . . 2 . . . . . . . . . . . . . 1 4 1 . . 1 . . 1 . . 1 4 1 . . . . . . . . 2 4 3 . . . . . . . . . . . . . . . 1 . . . . . 1
1 . . . 1 . . . . 2 . x . . . . . . 2 3 4 1 4 1 1 4 4 1 1 4 4 2 2 1 4 1 4 4 1 4 4 1 4 4 1 4 1 2 2 2 2 2 2 2 2 3 4 3 4 4 4 4 4 4 4 4 4 4 4 4 4 4 4 1 . . . . . 1
1 1 1 1 1 1 1 2 2 3 2 2 2 2 1 1 1 1 3 3 1 1 1 1 1 2 2 2 4 4 2 3 3 1 1 1 1 1 1 1 1 1 1 1 1 1 1 1 1 1 1 1 1 1 1 1 1 1 1 1 1 1 1 1 1 1 1 1 1 1 1 1 1 1 . . y . . 1
. . . . . . . . . . . . . . . . . . . . . . . . . . . . . . . . . . . . . . . . . . . . . . . . . . . . . . . . . . . . . . . . . 1 . . . . . . . . . . . . . 1
. . . . 1 . . . . . . . . . 1 . . . . . . . . . . . . . . . . . . . . . . . . . . . . . . . . . . . . . . . . . . . . . . . . . . 1 . 5 1 1 1 1 1 1 1 1 1 1 1 1
. . . . 1 . . . . . . . . . 1 . . . . . . . . . . . . . . . . . . . . . . . . . . . . . . . . . . . . . . . . . . . . . . . . . . 1 . 1 1 1 . . . . . . . . . .
. . . . 1 . . . . . . . . . 1 . . . . . . . . . . . . . . . . . . . . . . . . . . . . . . . . . . . . . . . . . . . . . . . . . . 1 . 1 1 1 . . . . . . . . . .
1 . . . . . . . . . . . . . 1 . . . . . . . . . . . . . . . . . . . . . . . . . . . . . . . . . . . . . . . . . . . . . . . . . . . . . . 1 . . . . . . . . . .
1 . . . . . . . . . . . . . 1 . . . . . . . . . . . . . . . . . . . . . . . . . . . . . . . . . . . . . . . . . . . . . . . . . . . . . . 1 . . . . . . . . . .
1 . . . . . . . . . . . . . 1 . . . . . . . . . . . . . . . . . . . . . . . . . . . . . . . . . . . . . . . . . . . . . . . 5 1 . . 2 . . 1 . . . . . . . . . .
1 . . . . . . . . . . . . . . . . . . 2 . . . . . . . . . . . . . . . . . . . . . . . . . . . . . . . . . . . . . . . . . . . 1 . . . . . 1 . . . . . . . . . .
1 d2 . . . . . 6 . . . . . . . . . . 2 3 4 1 4 1 1 4 4 1 . . 2 2 2 . . . . . x . . . 1 . . x . . . 1 . . x . . . 1 . . . . . . 1 4 4 4 4 4 1 . . . . . . . . . .
1 1 1 1 1 1 1 2 2 2 2 2 2 2 1 1 1 1 3 3 1 1 1 1 1 2 2 2 4 4 3 3 3 2 2 2 2 2 2 2 2 2 2 2 2 2 2 2 2 2 2 2 2 2 2 2 2 2 2 2 2 2 2 1 1 1 1 1 1 1 . . . . . . . . . .
